NO textures/
SO textures/
WE textures/
EA textures/

F 0,255,0
C 135,44,235

  11111111111
  10000000001
  10000000001
  1E000000001
  10000000001
  11111111111