NO textures/wall_n.png
SO textures/wall_s.png
WE textures/wall_w.png
EA textures/wall_e.png

F 0,255,0
C 135,44,235

  11111111111
  10000000001
  10000000001
  1N000000001
  10000000001
  11111111111