NO textures/
SO textures/
WE textures/
EA textures/

F 0,255,0
C 135,44,235

                        1111
                        1001
        111111111111111110001111111
        100000000011000000000000111
        100110000011100000000000001
        101100000000000000000000111
1111111110110000011100000000000001
100000000011000001110111111111111
1111011111111101110000001000001
1111011111111101110101001000001
1100000011010101110000001000101
1000000001000000110000001000011
10000000000000011010100100001
110000011101010111110111100011
11110111 1110101 10111101E0001
11111111 1111111 111111111111
